@@@@@@@@@@@@
#@@##@@##@@#
#@@......@@#
#..%%@@%%..#
#@@##@@##@@#
############